########################################
#......................................#
#......................................#
#............############..............#
#............#.........................#
#............#.........................#
#............###########...............#
#............#.........................#
#............#.........................#
#............#.........................#
#......................................#
#......................................#
#............###########...............#
#.................#....................#
#.................#....................#
#.................#....................#
#.................#....................#
#.................#....................#
#............###########...............#
#......................................#
#......................................#
#............###########...............#
#.................#....................#
#.................#....................#
#.................#....................#
#.................#....................#
#.................#....................#
#......................................#
#......................................#
########################################