########################################
#......................................#
#......................................#
#......................................#
#...........###############............#
#...........#..........................#
#...........#..........................#
#...........#..........................#
#...........#..........................#
#...........#..........................#
#...........#..........................#
#...........###############............#
#......................................#
#......................................#
#......................................#
#......................................#
#......................................#
#...........################...........#
#...........#..............#...........#
#...........#..............#...........#
#...........#..............#...........#
#...........#..............#...........#
#...........#..............#...........#
#...........#..............#...........#
#......................................#
#......................................#
#......................................#
#......................................#
#......................................#
########################################