########################################
#......................................#
#......................................#
#......................................#
#.....###############..................#
#......................................#
#......................................#
#......................................#
#......................................#
#......................................#
#......................................#
#................#.....................#
#................#.....................#
#................#.....................#
#................#.....................#
#................#.....................#
#................#.....................#
#................#.....................#
#......................................#
#......................................#
#......................................#
#......................................#
#......................................#
#......................................#
#...............###############........#
#......................................#
#......................................#
#......................................#
#......................................#
########################################

